2
12 12 L
2 1 11 12
X X X X X X X X X X X X
O O O X O X O O O O O X
X O X O O O O O X O O X
X O X O X X X O X X O X
X O O O X O O O O O O X
X X X O X X X X X O X X
X O O O X O O O O O O X
X O X X X O X O X X X X
X O X O O O X O O O X X
X O O O X O X O X O O O
X X X X X X X X X X X X
12 12 R
2 1 11 12
X X X X X X X X X X X X
O O O X O X O O O O O X
X O X X O X X O X O X X
X O X O O O O O X O O X
X O X O X X X O X X O X
X O O O X O O O O O O X
X X X O X X X X X O X X
X O O O X O O O O O O X
X O X X X O X O X X X X
X O X O O O X O O O X X
X O O O X O X O X O O O
X X X X X X X X X X X X